2222222222222222222222222222222222222222222
2_________________________________________2
2_________________________________________2
2_________________________________________2
2_________________________________________2
2_________________________________________2
211________3_______________________11111112
2_________111________________________222222
2______________________________11_______222
2______________________11_________________2
2_________________1_______________________2
2_________________________________________2
2___________111___________________________2
2________111222___________________________2
21_________22_____________________________2
2_________________________________________2
23________________________________________2
2111______________________________________2
2222______________________________________2
22_______111______________________________2
2_____________________0___________________2
23333333333333________________3333333333332
2111111111111111111111111111111111111111112
2222222222222222222222222222222222222222222