2222222222222222222222222222222222222222222
2_________________________________________2
2_________________________________________2
2_________________________________________2
2_________________________________________2
2____4____________________________________2
2_________________________________11______2
20___________4____________________________2
211____________________4444_______________2
2________________________________________12
2_________________________________________2
2_________________________________________2
2_____________________________________11112
2_______________________________________222
2_________________________4444____________2
2_________________________________________2
2________________1________________________2
2________4________________________________2
2111111___________________________________2
222222____________________________________2
2_________________________________________2
2333333333333333333333333333333333333333332
2111111111111111111111111111111111111111112
2222222222222222222222222222222222222222222