2222222222222222222222222222222222222222222
2_________________________________________2
2_________________________________________2
2_________________________________________2
2_________________________________________2
2_________________________________________2
2___________________________1111__________2
2_________________________________________2
2______________444444__________________3__2
2_______3____________________________444_02
2_____1414______________________________112
21________________________________________2
2_________________________________________2
2_________________________________________2
2111______________________________________2
22_______33_______________________________2
2_______11144_____________111_____________2
2_______________33____333_________________2
2_______________111111111_________________2
2________________2222222__________________2
2_________________________________________2
2333333333333333333333333333333333333333332
2111111111111111111111111111111111111111112
2222222222222222222222222222222222222222222